----------格式为：输入内容<Tab>响应内容1<Space>响应内容2……	----------
----------假装这是注释。不能有重复的行（包括开头），所以注释也不能重复。	----------
----------月份星期	----------
一月	一月 Jan. January
二月	二月 Feb. February
三月	三月 Mar. March
四月	四月 Apr. April
五月	五月 May
六月	六月 June
七月	七月 July
八月	八月 Aug. August
九月	九月 Sep. Sept. September
十月	十月 Oct. October
十一月	十一月 Nov. November
十二月	十二月 Dec. December
一月份	一月份 Jan. January
二月份	二月份 Feb. February
三月份	三月份 Mar. March
四月份	四月份 Apr. April
五月份	五月份 May
六月份	六月份 June
七月份	七月份 July
八月份	八月份 Aug. August
九月份	九月份 Sep. Sept. September
十月份	十月份 Oct. October
十一月份	十一月份 Nov. November
十二月份	十二月份 Dec. December
週一	週一 Mon. Monday
週二	週二 Tue. Tuesday
週三	週三 Wed. Wednesday
週四	週四 Thu. Thurs. Thursday
週五	週五 Fri. Friday
週六	週六 Sat. Saturday
週日	週日 Sun. Sunday
禮拜一	禮拜一 Mon. Monday
禮拜二	禮拜二 Tue. Tuesday
禮拜三	禮拜三 Wed. Wednesday
禮拜四	禮拜四 Thu. Thurs. Thursday
禮拜五	禮拜五 Fri. Friday
禮拜六	禮拜六 Sat. Saturday
禮拜日	禮拜日 Sun. Sunday
星期一	星期一 Mon. Monday
星期二	星期二 Tue. Tuesday
星期三	星期三 Wed. Wednesday
星期四	星期四 Thu. Thurs. Thursday
星期五	星期五 Fri. Friday
星期六	星期六 Sat. Saturday
星期日	星期日 Sun. Sunday
----------偏旁部首	----------
厂部	厂部 ⺁
偏廠	偏廠 厂
偏廠兒	偏廠兒 厂
反字框	反字框 ⺁
匚部	匚部 匚
區字框	區字框 匚
三框	三框 匚
三框兒	三框兒 匚
刀部	刀部 刂
立刀旁	立刀旁 刂
立刀	立刀 刂
冂部	冂部 冂 ⺆
同字框	同字框 冂 ⺆
單人旁	單人旁 亻
人字旁	人字旁 亻
單立人	單立人 亻
斜刀頭	斜刀頭 ⺈
負字頭	負字頭 ⺈
包字頭	包字頭 勹
風字頭	風字頭 𠘨
鳳字框	鳳字框 𠘨
几字頭	几字頭 𠘨
几字底	几字底 𠘨
亠部	亠部 亠
京字頭	京字頭 亠
冫部	冫部 冫
兩點水	兩點水 冫
冰字旁	冰字旁 冫
八部	八部 丷
倒八	倒八 丷
兰字頭	兰字頭 丷
八字頭	八字頭 丷
八字底	八字底 丷
倒八字	倒八字 丷
冖部	冖部 冖
禿寶蓋	禿寶蓋 冖
言部	言部 讠 訁
言字旁	言字旁 讠 訁
兇字框	兇字框 凵
凵部	凵部 凵
卩部	卩部 卩
耳刀旁	耳刀旁 卩 阝
單耳旁	單耳旁 卩
單耳刀	單耳刀 卩
單耳朵	單耳朵 卩
邑部	邑部 阝
阜部	阜部 阝
雙耳旁	雙耳旁 阝
雙耳刀	雙耳刀 阝
左耳刀	左耳刀 阝
右耳刀	右耳刀 阝
厶部	厶部 厶
私字旁	私字旁 厶
廴部	廴部 廴
建之旁	建之旁 廴
㔾部	㔾部 㔾
仓字底	仓字底 㔾
土部	土部 土
提土旁	提土旁 土
手部	手部 扌
提手旁	提手旁 扌
艸部	艸部 艹
草頭	草頭 艹
草字頭	草字頭 艹
廾部	廾部 廾
弄字底	弄字底 廾
尢部	尢部 尢
尤字旁	尤字旁 尢
國字框	國字框 囗
大口框	大口框 囗
方框	方框 囗
雙人旁	雙人旁 彳
雙立人	雙立人 彳
彳部	彳部 彳
彡部	彡部 彡
三撇	三撇 彡
三撇兒	三撇兒 彡
犬部	犬部 犭
反犬旁	反犬旁 犭
夂部	夂部 夂
折文	折文 夂
折文兒	折文兒 夂
折文旁	折文旁 夂
冬字頭	冬字頭 夂
食部	食部 饣
食字旁	食字旁 饣
爿部	爿部 丬 爿
將字旁	將字旁 丬 爿
水部	水部 氵
三點水	三點水 氵
心部	心部 忄
豎心	豎心 忄
豎心旁	豎心旁 忄
宀部	宀部 宀
寶蓋	寶蓋 宀
寶蓋兒	寶蓋兒 宀
寶蓋頭	寶蓋頭 宀
寶蓋兒頭	寶蓋兒頭 宀
辵部	辵部 辶
走之	走之 辶
走之旁	走之旁 辶
彐部	彐部 彐
雪字底	雪字底 彐
橫山	橫山 彐
子部	子部 孑
子字旁	子字旁 孑
糸部	糸部 纟 糹 糸
絞絲	絞絲 纟 糹 糸
絞絲兒	絞絲兒 纟 糹 糸
絞絲旁	絞絲旁 纟 糹 糸
絞絲兒旁	絞絲兒旁 纟 糹 糸
亂絞絲	亂絞絲 纟 糹 糸
亂絞絲兒	亂絞絲兒 纟 糹 糸
絞絲底	絞絲底 纟 糹 糸
幼字旁	幼字旁 幺
巛部	巛部 巛
三拐	三拐 巛
三拐兒	三拐兒 巛
玉部	玉部 王
斜玉旁	斜玉旁 王
老字頭	老字頭 耂
牛字旁	牛字旁 牜 ⺧
反文	反文 攵
反文旁	反文旁 攵
爪字頭	爪字頭 爫
四點底	四點底 灬
四點水	四點水 灬
示字旁	示字旁 礻
示補	示補 礻
示補兒	示補兒 礻
春字頭	春字頭 春
四字頭	四字頭 罒
扁四頭	扁四頭 罒
金字旁	金字旁 钅
病字頭	病字頭 疒
病字旁	病字旁 疒
病旁	病旁 疒
衣字旁	衣字旁 衤
衣補	衣補 衤
衣補兒	衣補兒 衤
登字頭	登字頭 癶
西字頭	西字頭 覀
虎字頭	虎字頭 虍
竹字頭	竹字頭 ⺮
羊字旁	羊字旁 ⺶ ⺷
羊字頭	羊字頭 ⺷ ⺶
卷字頭	卷字頭 龹
足字旁	足字旁 ⻊
髦字頭	髦字頭 髟
石字頭	石字頭 丆
左右結構	左右結構 ⿰
上下結構	上下結構 ⿱
左中右結構	左中右結構 ⿲
上中下結構	上中下結構 ⿳
全包圍結構	全包圍結構 ⿴
半包圍結構	半包圍結構 ⿵ ⿶ ⿷ ⿼ ⿸ ⿹ ⿺ ⿽
----------著名表演艺术家	----------
愛田飛鳥	愛田飛鳥 あいだ飛鳥
愛乃娜美	愛乃娜美 愛乃なみ
安齋拉拉	安齋拉拉 安齋らら 宇都宫紫苑 宇都宮しをん RION
蒼井空	蒼井空 蒼井そら
長谷川理穗	長谷川理穗 長谷川リホ
彩美旬果	彩美旬果 あやみ旬果
春咲涼	春咲涼 春咲りょう
蒂亞	蒂亞 蒂亞 ティア
楪可憐	楪可憐 楪カレン
妃悠愛	妃悠愛 妃悠愛 长泽杏奈 長澤杏奈
長澤杏奈	長澤杏奈 長澤杏奈 妃悠爱 妃悠愛
楓可憐	楓可憐 楓カレン 田中柠檬 田中レモン
楓花戀	楓花戀 楓カレン 田中柠檬 田中レモン
宮下華奈	宮下華奈 宮下華奈
古川伊織	古川伊織 古川いおり
廣瀨里緒菜	廣瀨里緒菜 広瀬りおな
河北春菜	河北春菜 河北はるな
吉川蓮	吉川蓮 吉川蓮
吉澤明步	吉澤明步 吉沢明歩
鈴村愛里	鈴村愛里 鈴村あいり
涼森玲夢	涼森玲夢 涼森れむ
林由奈	林由奈 林ゆな
凜音桃花	凜音桃花 凛音とうか
里美尤利婭	里美尤利婭 里美ゆりあ
蘆名尤莉亞	蘆名尤莉亞 芦名ユリア
美雪艾莉絲	美雪艾莉絲 美雪ありす
目黑惠	目黑惠 目黒めぐみ
明里紬	明里紬 明里つむぎ
七海蒂娜	七海蒂娜 七海ティナ
天海翼	天海翼 天海つばさ
桃谷繪里香	桃谷繪里香 桃谷エリカ
辻井穗乃果	辻井穗乃果 辻井ほのか
橋本有菜	橋本有菜 橋本ありな 新有菜 新ありな
深田詠美	深田詠美 深田えいみ
三上悠亞	三上悠亞 三上悠亜
桃乃木香奈	桃乃木香奈 桃乃木かな
武藤綾香	武藤綾香 武藤あやか
希島愛理	希島愛理 希島あいり
夏希栗	夏希栗 夏希まろん
希崎傑西卡	希崎傑西卡 希崎ジェシカ
小澤瑪利亞	小澤瑪利亞 小澤マリア
小島南	小島南 小島みなみ
相澤南	相澤南 相沢みなみ
新有菜	新有菜 新ありな 桥本有菜 橋本ありな
星宮一花	星宮一花 星宮一花
星野景子	星野景子 ほしの景子
星野娜美	星野娜美 星野ナミ
筱田步美	筱田步美 篠田あゆみ
柚木蒂娜	柚木蒂娜 柚木ティナ
有賀由愛	有賀由愛 有賀ゆあ
乙白沙也加	乙白沙也加 乙白さやか
櫻井步	櫻井步 桜井あゆ
櫻井彩	櫻井彩 桜井彩
櫻空桃	櫻空桃 桜空もも
宇都宮紫苑	宇都宮紫苑 宇都宮しをん 安斋拉拉 安齋らら RION
一之瀨亞美莉	一之瀨亞美莉 一ノ瀬アメリ
櫻木凜	櫻木凜 桜木凛
園田美櫻	園田美櫻 園田みおん
永野司	永野司 永野つかさ
早川瀨里奈	早川瀨里奈 早川瀬里奈
椎名由奈	椎名由奈 椎名ゆな
竹內有紀	竹內有紀 竹内有紀
三宮椿	三宮椿 三宮つばき
藍芽水月	藍芽水月 藍芽みずき
星野明	星野明 星野あかり
蓮實克蕾兒	蓮實克蕾兒 蓮実クレア
香苗玲音	香苗玲音 香苗レノン
有原步美	有原步美 有原あゆみ
美谷朱里	美谷朱里 美谷あかり
水川堇	水川堇 水川スミレ 水稀美里 水稀みり 百多えみり
水稀美里	水稀美里 水稀みり 水川堇 水川スミレ 百多えみり
小宵虎南	小宵虎南 小宵こなん
新村晶	新村晶 新村あかり
森澤佳奈	森澤佳奈 森沢かな 饭冈佳奈子 飯岡かなこ
飯岡佳奈子	飯岡佳奈子 飯岡かなこ 森泽佳奈 森沢かな
朝日奈花戀	朝日奈花戀 朝日奈かれん
高橋聖子	高橋聖子 高橋しょう子
西宮夢	西宮夢 西宮ゆめ
藤森里穗	藤森里穗 藤森里穂
木村穗乃香	木村穗乃香 木村穂乃香
神宮寺奈緒	神宮寺奈緒 神宮寺ナオ
水卜櫻	水卜櫻 水卜さくら
愛音麻里亞	愛音麻里亞 愛音まりあ
良音薺	良音薺 良音なずな
本庄鈴	本庄鈴 本庄鈴
明日花綺羅	明日花綺羅 明日花キララ
大橋未久	大橋未久 大橋未久
瀨名光莉	瀨名光莉 瀬名きらり
栗山莉緒	栗山莉緒 栗山莉緒
紗紗原百合	紗紗原百合 紗々原ゆり
堀北灣	堀北灣 堀北わん
沖田杏梨	沖田杏梨 沖田杏梨
天使萌	天使萌 天使もえ
西條琉璃	西條琉璃 西條るり
君島美緒	君島美緒 君島みお
波多野結衣	波多野結衣 波多野結衣
松下紗榮子	松下紗榮子 松下紗栄子
山手梨愛	山手梨愛 山手梨愛
瀨亞美莉	瀨亞美莉 瀬アメリ
望月理沙	望月理沙 望月りさ
上原瑞穗	上原瑞穗 上原瑞穂
岬奈奈美	岬奈奈美 岬ななみ
神菜美舞	神菜美舞 神菜美まい
白桃花	白桃花 白桃はな
栗宮雙葉	栗宮雙葉 栗宮ふたば
飛鳥里伊奈	飛鳥里伊奈 飛鳥りいな
天音真比奈	天音真比奈 天音まひな
凰香奈芽	凰香奈芽 凰かなめ
翼舞	翼舞 つばさ舞
神木麗	神木麗 神木麗
小花暖	小花暖 小花のん
山口葉琉	山口葉琉 山口葉瑠
赤目麗蘭	赤目麗蘭 赤目レイラン
天馬唯	天馬唯 天馬ゆい
七森莉莉	七森莉莉 七ツ森りり
田中檸檬	田中檸檬 田中レモン 枫可怜 枫花恋 楓カレン
小湊四葉	小湊四葉 小湊よつ葉
愛寶鈴	愛寶鈴 愛宝すず
愛弓涼	愛弓涼 愛弓りょう
愛世夢羅	愛世夢羅 愛世くらら
愛田奈奈	愛田奈奈 愛田奈々
愛原沙耶	愛原沙耶 爱原さえ
愛澤有紗	愛澤有紗 愛沢有紗
安達夕莉	安達夕莉 安達夕莉
庵姬花	庵姬花 庵ひめか
安美波	安美波 安みなみ
安位薰	安位薰 安位カヲル
奧井楓	奧井楓 奥井楓
八掛海	八掛海 八掛うみ
八木奈奈	八木奈奈 八木奈々
白坂美杏	白坂美杏 白坂みあん
白川柚子	白川柚子 白川ゆず
白峰美羽	白峰美羽 白峰ミウ
百瀨飛鳥	百瀨飛鳥 百瀬あすか
柏木小夏	柏木小夏 柏木こなつ
白木優子	白木優子 白木優子
白崎彩葉	白崎彩葉 白崎いろは
百永紗里奈	百永紗里奈 百永さりな
坂道美琉	坂道美琉 坂道みる miru
坂井成羽	坂井成羽 坂井なるは
寶田萌奈美	寶田萌奈美 宝田もなみ
北川愛莉香	北川愛莉香 北川エリカ
北川杏樹	北川杏樹 北川杏樹
北川柚子	北川柚子 北川ゆず
本鄉愛	本鄉愛 本郷愛 二阶堂梦 二階堂夢
本真友里	本真友里 本真ゆり
本庄優花	本庄優花 本庄優花
並木優	並木優 並木優
倉本堇	倉本堇 倉本すみれ
倉多真央	倉多真央 倉多まお
朝比奈七瀨	朝比奈七瀨 朝比奈ななせ
朝日鈴	朝日鈴 朝日りん
朝日奈可憐	朝日奈可憐 朝日奈かれん
朝田日葵	朝田日葵 朝田ひまり
辰巳唯	辰巳唯 辰巳ゆい
初川南	初川南 初川みなみ
川北里菜	川北里菜 川北りな
川北明沙	川北明沙 川北メイサ
川村真矢	川村真矢 川村まや
川越唯	川越唯 川越ゆい
椎名空	椎名空 椎名そら
吹石玲奈	吹石玲奈 吹石れな
春菜華	春菜華 春菜はな
椿莉香	椿莉香 椿りか
大槻響	大槻響 大槻ひびき
稻場流花	稻場流花 稲場るか
稻川夏目	稻川夏目 稲川なつめ 黑川堇 黒川すみれ
稻森美憂	稻森美憂 稲森美憂
冬愛琴音	冬愛琴音 冬愛ことね
東凜	東凜 東凛
東條夏	東條夏 東條なつ
冬月楓	冬月楓 冬月かえで
東雲美玲	東雲美玲 東雲みれい
二宮光	二宮光 二宮ひかり
二階堂夢	二階堂夢 二階堂夢 本乡爱 本郷愛
兒玉玲奈	兒玉玲奈 児玉れな
楓芙愛	楓芙愛 楓ふうあ
逢見梨花	逢見梨花 逢見リカ
風間由美	風間由美 風間ゆみ
逢月日葵	逢月日葵 逢月ひまり
富安玲於奈	富安玲於奈 冨安れおな
紺野光	紺野光 紺野ひかる
圓井萌華	圓井萌華 円井萌華
根尾明里	根尾明里 根尾あかり
宮城理惠	宮城理惠 宮城りえ
宮島芽衣	宮島芽衣 宮島めい
工藤拉拉	工藤拉拉 工藤ララ
工藤美紗	工藤美紗 工藤美紗
宮西光	宮西光 宮西ひかる
宮下玲奈	宮下玲奈 宮下玲奈
宮澤千春	宮澤千春 宮沢ちはる
廣瀨光希	廣瀨光希 広瀬みつき
廣瀨蓮	廣瀨蓮 広瀬蓮
河北朝陽	河北朝陽 河北あさひ
河合明日菜	河合明日菜 河合あすな
河南實里	河南實里 河南実里
黑川堇	黑川堇 黒川すみれ 稻川夏目 稲川なつめ
黑木一香	黑木一香 黒木いちか
橫宮七海	橫宮七海 横宮七海
胡桃櫻	胡桃櫻 胡桃さくら
花狩舞	花狩舞 花狩まい
花澤日葵	花澤日葵 花沢ひまり 木下日葵 木下ひまり
皇柚子	皇柚子 皇ゆず
吉川愛美	吉川愛美 吉川あいみ
吉高寧寧	吉高寧寧 吉高寧々
吉根柚莉愛	吉根柚莉愛 吉根ゆりあ
吉良鈴	吉良鈴 吉良りん
跡美朱里	跡美朱里 跡美しゅり
姬咲華	姬咲華 姫咲はな
吉永好美	吉永好美 吉永このみ
佳苗琉花	佳苗琉花 佳苗るか
架乃由羅	架乃由羅 架乃ゆら
加藤綾野	加藤綾野 加藤あやの
岬櫻	岬櫻 岬さくら
筧純	筧純 筧ジュン 鹫尾芽衣 鷲尾めい
菅野松雪	菅野松雪 菅野さゆき
結城莉乃	結城莉乃 結城りの
結城美佐	結城美佐 結城みさ
皆瀨明里	皆瀨明里 皆瀬あかり
皆月光	皆月光 皆月ひかる
九條滿	九條滿 九条みちる
鷲尾芽衣	鷲尾芽衣 鷲尾めい 笕纯 筧ジュン
九野雛乃	九野雛乃 九野ひなの
堀咲莉婭	堀咲莉婭 堀咲りあ
堀澤茉由	堀澤茉由 堀沢茉由
葵司	葵司 葵つかさ
葵伊吹	葵伊吹 葵いぶき 翼葵 翼あおい
瀨名步	瀨名步 瀬名あゆむ
瀨名光	瀨名光 瀬名ひかり
瀨田一花	瀨田一花 瀬田一花
蕾	蕾 つぼみ
立花美涼	立花美涼 立花美涼
涼宮琴音	涼宮琴音 涼宮琴音
綾瀨心	綾瀨心 綾瀬こころ
鈴木心春	鈴木心春 鈴木心春
鈴音鈴	鈴音鈴 鈴音りん
鈴原愛蜜莉	鈴原愛蜜莉 铃原エミリ
鈴原美蘭	鈴原美蘭 鈴原みらん
瑠川里菜	瑠川里菜 瑠川リナ
瀧川花音	瀧川花音 瀧川花音
蘿琳花戀	蘿琳花戀 ローレン花恋
麻倉優	麻倉優 麻倉憂
美波那美	美波那美 美波なみ
美波桃	美波桃 美波もも
美雛	美雛 みひな 永井美雏 永井みひな
美里有紗	美里有紗 美里有紗
美乃雀	美乃雀 美乃すずめ
美神葵	美神葵 美神あおい
美咲結衣	美咲結衣 美咲結衣
美園和花	美園和花 美園和花
美之島惠理	美之島惠理 美ノ嶋めぐり
美竹鈴	美竹鈴 美竹すず
夢見露	夢見露 夢見るぅ
夢乃愛華	夢乃愛華 夢乃あいか
彌生美月	彌生美月 弥生みづき
明日見未來	明日見未來 明日見未来
末廣純	末廣純 末広純
木下凜凜子	木下凜凜子 木下凛々子
木下日葵	木下日葵 木下ひまり 花泽日葵 花沢ひまり
南條一香	南條一香 南条いちか
七海雛	七海雛 七海ひな
崎惠梨香	崎惠梨香 尾崎えりか
七瀨愛麗絲	七瀨愛麗絲 七瀬アリス
七瀨伊織	七瀨伊織 七瀬いおり
七澤美亞	七澤美亞 七沢みあ
前田香織	前田香織 前田かおり
青空光	青空光 青空ひかり
丘惠理奈	丘惠理奈 丘えりな
仁科百華	仁科百華 仁科百華
日向楓	日向楓 日向かえで
日向由良	日向由良 日向ゆら
日向真凜	日向真凜 ひなたまりん
榮川乃亞	榮川乃亞 栄川乃亜
宍戶里帆	宍戶里帆 宍戸里帆
若宮穗乃	若宮穗乃 若宮穂乃
三舩美鈴	三舩美鈴 三舩みすず
三浦步美	三浦步美 三浦歩美
三田櫻	三田櫻 三田サクラ
三尾惠	三尾惠 三尾めぐ
三葉千春	三葉千春 三葉ちはる
森川玉緒	森川玉緒 森川玉緒
紗倉真菜	紗倉真菜 紗倉まな
沙月芽衣	沙月芽衣 さつき芽衣
上坂芽衣	上坂芽衣 上坂めい
上羽絢	上羽絢 上羽絢
上原亞衣	上原亞衣 上原亜衣
澀谷美希	澀谷美希 渋谷美希
神納花	神納花 神納花
深田結梨	深田結梨 深田結梨
神雪	神雪 神ユキ
市川雅美	市川雅美 市川まさみ
似鳥日菜	似鳥日菜 似鳥日菜
時田亞美	時田亞美 時田亜美
樞木葵	樞木葵 枢木あおい
水島津實	水島津實 水嶋あずみ
水戶香奈	水戶香奈 水戸かな
水無瀨優夏	水無瀨優夏 みなせ優夏
水野朝陽	水野朝陽 水野朝陽
水原美園	水原美園 水原みその
水澤乃乃	水澤乃乃 水沢のの
四宮愛麗絲	四宮愛麗絲 四宮ありす
松本菜奈實	松本菜奈實 松本菜奈実
松本一香	松本一香 松本いちか
松岡千菜	松岡千菜 松岡ちな
松井優子	松井優子 松井優子
穗高結花	穗高結花 穂高結花
穗高有紀	穗高有紀 穂高ゆうき
穗花愛里	穗花愛里 穂花あいり
桃尻香名芽	桃尻香名芽 桃尻かなめ
桃瀨友梨奈	桃瀨友梨奈 桃瀬友梨奈
桃園怜奈	桃園怜奈 桃園怜奈
藤環奈	藤環奈 藤かんな
藤井愛紗	藤井愛紗 藤井あいさ
藤井一夜	藤井一夜 藤井いよな
藤浦惠	藤浦惠 藤浦めぐ
天宮花南	天宮花南 天宮花南
天晴乃愛	天晴乃愛 天晴乃愛
天使亞夢	天使亞夢 あまつか亜夢
天音唯	天音唯 天音ゆい
田中寧寧	田中寧寧 田中ねね
桐谷茉莉	桐谷茉莉  桐谷まつり
未步奈奈	未步奈奈 未歩なな
唯井真尋	唯井真尋 唯井まひろ
五十嵐夏	五十嵐夏 五十嵐なつ
舞原聖	舞原聖 舞原聖
西宮好美	西宮好美 西宮このみ
汐世	汐世 有栖花绯 有栖花あか
希咲艾瑪	希咲艾瑪 希咲エマ
希咲亞里子	希咲亞里子 希咲アリス
西野星夏	西野星夏 西野セイナ
西元明沙	西元明沙 西元めいさ
希志愛野	希志愛野 希志あいの
夏木玲	夏木玲 夏木りん
夏目響	夏目響 夏目響
香澄果穗	香澄果穗 かすみ果穂
香澄莉子	香澄莉子 香澄りこ
香水純	香水純 香水じゅん
相澤莉娜	相澤莉娜 相澤リナ
小倉七海	小倉七海 小倉七海
小倉由菜	小倉由菜 小倉由菜
小川阿佐美	小川阿佐美 小川あさ美
小島純名	小島純名 小嶋ジュンナ
筱惠美	筱惠美 篠めぐみ
小栗美優	小栗美優 小栗みゆ
小梅惠奈	小梅惠奈 小梅えな
小泉日向	小泉日向 小泉ひなた
筱田優	筱田優 篠田ゆう
新村朱里	新村朱里 新村あかり
新井裡真	新井裡真 新井リマ
星奈愛	星奈愛 星奈あい
芽森滴	芽森滴 芽森しずく
葉愛	葉愛 叶愛
葉風優莉亞	葉風優莉亞 葉風ゆりあ
葉月涼子	葉月涼子 葉月涼子
乙愛麗絲	乙愛麗絲 乙アリス
伊東千奈美	伊東千奈美 伊東ちなみ
一宮希帆	一宮希帆 一宮希帆
伊賀真子	伊賀真子 伊賀まこ
翼葵	翼葵 翼あおい 葵伊吹 葵いぶき
一乃葵	一乃葵 一乃あおい
伊藤沙也香	伊藤沙也香 うんぱい
伊藤聖夏	伊藤聖夏 伊藤聖夏
伊織雛乃	伊織雛乃 伊織ひなの
一之瀨梓	一之瀨梓 一ノ瀬梓
伊織羽音	伊織羽音 伊織羽音
櫻井艾蜜莉	櫻井艾蜜莉 桜井エミリ
櫻木優希音	櫻木優希音 桜木優希音
櫻心美	櫻心美 桜ここみ
櫻由羅	櫻由羅 さくらゆら
永井瑪利亞	永井瑪利亞 永井マリア
永瀨唯	永瀨唯 永瀬ゆい
由愛可奈	由愛可奈 由愛可奈
有岡美羽	有岡美羽 有岡みう
優梨舞奈	優梨舞奈 優梨まいな
有栖花緋	有栖花緋 有栖花あか 汐世
悠紗有朱	悠紗有朱 悠紗ありす
柚月亞衣	柚月亞衣 柚月あい
雨宮琴音	雨宮琴音 雨宮琴音
玉名美良	玉名美良 玉名みら
與田櫻	與田櫻 与田さくら
羽咲美晴	羽咲美晴 羽咲みはる
月見伊織	月見伊織 月見伊織
月乃雛	月乃雛 月乃ひな
月乃露娜	月乃露娜 月乃ルナ
月野霞	月野霞 月野かすみ
早野詩	早野詩 はやのうた
早乙女露依	早乙女露依 早乙女ルイ
齋藤亞美里	齋藤亞美里 斎藤あみり
長澤梓	長澤梓 長澤あずさ
真白愛梨	真白愛梨 真白愛梨
真白希實	真白希實 真白希実
知花梅莎	知花梅莎 知花メイサ
織田真子	織田真子 織田真子
仲村美羽	仲村美羽 仲村みう
柊木楓	柊木楓 柊木楓
中山文香	中山文香 中山ふみか
渚光希	渚光希 渚みつき
竹內愛	竹內愛 竹内あい
竹內乃愛	竹內乃愛 竹内乃愛
竹田夢	竹田夢 竹田ゆめ
朱音唯	朱音唯 朱音ゆい
梓光莉	梓光莉 梓ヒカリ
佐山愛	佐山愛 佐山愛
佐佐木明希	佐佐木明希 佐々木あき
松本梨穗	松本梨穗 松本梨穂
佐野由真	佐野由真 佐野ゆま
天川空	天川空 天川そら
宮瀨里子	宮瀨里子 宮瀬リコ
夢實香苗	夢實香苗 夢実かなえ
勞倫花戀	勞倫花戀 ローレン花恋
美咲佳奈	美咲佳奈 美咲かんな
春陽萌花	春陽萌花 春陽モカ
----------生活大爆炸&老友记	----------
謝耳朵	謝耳朵 Sheldon
謝爾頓	謝爾頓 Sheldon
Sheldon	Sheldon 謝爾頓 謝耳朵
萊納德	萊納德 Leonard
Leonard	Leonard 萊納德
佩妮	佩妮 Penny
Penny	Penny 佩妮
伯納黛特	伯納黛特 Bernadette
Bernadette	Bernadette 伯納黛特
艾米	艾米 Amy
Amy	Amy 艾米
霍華德	霍華德 Howard
Howard	Howard 霍華德
拉傑什	拉傑什 Rajesh
Rajesh	Rajesh 拉傑什
瑞秋	瑞秋 Rachel
Rachel	Rachel 瑞秋
莫妮卡	莫妮卡 Monica
Monica	Monica 莫妮卡
喬伊	喬伊 Joey
Joey	Joey 喬伊
羅斯	羅斯 Ross
Ross	Ross 羅斯
錢德勒	錢德勒 Chandler
Chandler	Chandler 錢德勒
菲比	菲比 Phoebe
Phoebe	Phoebe 菲比
----------键盘符号	----------
cmd	cmd Command ⌘
command	command ⌘
Ctrl	Ctrl Control ⌃
control	control ⌃
Opt	Opt Option ⌥
option	option ⌥
shift	shift ⇧
tab	tab ⇥ 	
Caps	Caps CapsLock ⇪
CapsLock	CapsLock ⇪
return	return ⏎
enter	enter ⏎
space	space ␣
backspace	backspace ⌫
Del	Del Delete ⌫
delete	delete ⌫
Esc	Esc Escape ⎋
eject	eject ⏏
----------二叠字	----------
兩個火	兩個火 炎 炏
兩個土	兩個土 圭
兩個一	兩個一 二
兩個二	兩個二 亖
兩個山	兩個山 岀 屾
兩個口	兩個口 吕 吅
兩個田	兩個田 畕
兩個九	兩個九 𠃙
兩個飞	兩個飞 𠃧
兩個戈	兩個戈 戔
兩個兀	兩個兀 𠀘
兩個𡥦	兩個𡥦 𡦪
兩個巾	兩個巾 𢁝
兩個左	兩個左 𢀡
兩個母	兩個母 𣫯
兩個来	兩個来 𠐇
兩個凡	兩個凡 𠘻
兩個夕	兩個夕 多 𡖇
兩個彐	兩個彐 𢑑
兩個𢎘	兩個𢎘 𢎙
兩個明	兩個明 𣊧
兩個朿	兩個朿 棘 棗
兩個乂	兩個乂 爻
兩個曰	兩個曰 昌
兩個尸	兩個尸 𡰲
兩個八	兩個八 𠔁
兩個而	兩個而 𦓔
兩個羊	兩個羊 𫅓
兩個马	兩個马 𩥋
兩個卅	兩個卅 𢌽
兩個巛	兩個巛 𡿭
兩個比	兩個比 𣬅
兩個申	兩個申 𤱓
兩個余	兩個余 𠎳
兩個罒	兩個罒 𮊂
兩個㐅	兩個㐅 𬼆
兩個金	兩個金 鍂
兩個木	兩個木 林
兩個水	兩個水 沝
兩個風	兩個風 䬕
兩個石	兩個石 砳
兩個日	兩個日 昍
兩個月	兩個月 朋
兩個目	兩個目 䀠
兩個白	兩個白 㿟
兩個百	兩個百 皕
兩個耳	兩個耳 聑
兩個屮	兩個屮 艸
兩個廿	兩個廿 𠦜
兩個卄	兩個卄 卌
兩個虫	兩個虫 䖵
兩個魚	兩個魚 䲆 𩺰
兩個牛	兩個牛 牪 𤘧
兩個虎	兩個虎 虤
兩個龍	兩個龍 龖
兩個馬	兩個馬 騳
兩個犬	兩個犬 㹜
兩個人	兩個人 从 仌
兩個入	兩個入 𠓜
兩個习	兩個习 羽
兩個卪	兩個卪 𠨖
兩個㔾	兩個㔾 𠨎
兩個几	兩個几 𠘬
兩個乙	兩個乙 𠃐
兩個大	兩個大 夶 㚐
兩個夫	兩個夫 㚘
兩個禾	兩個禾 秝
兩個干	兩個干 幵
兩個井	兩個井 㐩
兩個斤	兩個斤 斦
兩個片	兩個片 㸞
兩個牙	兩個牙 𤘆
兩個炎	兩個炎 燚
兩個弓	兩個弓 弜
兩個永	兩個永 𣴏
兩個亦	兩個亦 𠅯
兩個手	兩個手 𢪒 抙
兩個毛	兩個毛 㲎
兩個王	兩個王 玨
兩個男	兩個男 𤲶
兩個女	兩個女 奻 㚣
兩個又	兩個又 双 㕛
兩個支	兩個支 𢺸
兩個隻	兩個隻 䨇
兩個古	兩個古 𠳬
兩個吉	兩個吉 喆 𡔯
兩個舌	兩個舌 𦧚
兩個言	兩個言 誩 𧨟
兩個户	兩個户 𢨯 𢨳
兩個启	兩個启 𢩙
兩個來	兩個來 㯤
兩個桼	兩個桼 𣠬
兩個旡	兩個旡 兓
兩個歹	兩個歹 㱛
兩個厶	兩個厶 厸 㕕
兩個匕	兩個匕 比
兩個幺	兩個幺 𢆶
兩個玄	兩個玄 玆
兩個心	兩個心 𢗰
兩個力	兩個力 𠠴
兩個欠	兩個欠 𣢐
兩個子	兩個子 孖
兩個予	兩個予 㐨
兩個享	兩個享 㝇
兩個立	兩個立 竝
兩個音	兩個音 䪭
兩個竟	兩個竟 竸
兩個竞	兩個竞 競
兩個兄	兩個兄 㒭
兩個見	兩個見 覞
兩個貝	兩個貝 賏
兩個辛	兩個辛 辡
兩個瓜	兩個瓜 㼌
兩個呆	兩個呆 槑
兩個果	兩個果 𣛕
兩個鳥	兩個鳥 𪅝
兩個巢	兩個巢 𢀌
兩個禺	兩個禺 𥝉
兩個巿	兩個巿 𢂏
兩個句	兩個句 𠣪
兩個奇	兩個奇 㚡
兩個真	兩個真 㒹
兩個尹	兩個尹 𡱉
兩個昔	兩個昔 𣊣
兩個易	兩個易 𣊷
兩個臣	兩個臣 𦣦 𫇆
兩個面	兩個面 𩈳 𩈲
兩個先	兩個先 兟
兩個老	兩個老 䎜
兩個示	兩個示 祘
兩個至	兩個至 臸
兩個生	兩個生 甡
兩個車	兩個車 䡛
兩個足	兩個足 踀
兩個區	兩個區 𠥺
兩個香	兩個香 𩡐 𩡌
兩個隹	兩個隹 雔
兩個牟	兩個牟 𤚅
兩個豕	兩個豕 豩
兩個𠂢	兩個𠂢 𠃄
兩個畐	兩個畐 㽬
兩個㣇	兩個㣇 㣈
兩個邑	兩個邑 䣈
兩個堯	兩個堯 㚁
兩個秉	兩個秉 𥡝
兩個倉	兩個倉 𠑐
兩個東	兩個東 㯥
兩個善	兩個善 𡆃
兩個僉	兩個僉 𠑲
兩個齒	兩個齒 𪙹
兩個喜	兩個喜 囍
兩個走	兩個走 𧼂
兩個止	兩個止 𣥖 𣥕
兩個昌	兩個昌 𣊫
兩個串	兩個串 𠁷
兩個米	兩個米 𥹫
兩個束	兩個束 𣗥 𬃷
兩個隶	兩個隶 𨽼
兩個不	兩個不 𫠭
兩個龙	兩個龙 𱍂
兩個乞	兩個乞 𬼠
兩個夋	兩個夋 𭐪
兩個天	兩個天 𭑈
----------三叠字	----------
三個生	三個生 㽓
三個秦	三個秦 䆐
三個若	三個若 䖃
三個雲	三個雲 䨺
三個人	三個人 众 㐺
三個刀	三個刀 刕
三個十	三個十 卉 𠦄
三個力	三個力 劦
三個原	三個原 厵
三個厶	三個厶 厽
三個又	三個又 叒
三個口	三個口 品 𠱠
三個七	三個七 㐂
三個吉	三個吉 嚞 𡕇
三個土	三個土 垚
三個士	三個士 壵
三個女	三個女 姦
三個子	三個子 孨 𡥦
三個小	三個小 尛 𡭯
三個心	三個心 惢
三個手	三個手 掱
三個日	三個日 晶 晿
三個木	三個木 森 𣓏
三個止	三個止 歮
三個毛	三個毛 毳
三個水	三個水 淼 㴇
三個泉	三個泉 灥
三個火	三個火 焱 㷋
三個牛	三個牛 犇
三個犬	三個犬 猋
三個田	三個田 畾
三個白	三個白 皛
三個目	三個目 瞐
三個直	三個直 矗
三個石	三個石 磊
三個羊	三個羊 羴
三個耳	三個耳 聶
三個舌	三個舌 舙 𦧵
三個屮	三個屮 芔
三個虫	三個虫 蟲
三個言	三個言 譶 𧭛
三個贝	三個贝 赑
三個車	三個車 轟
三個金	三個金 鑫
三個隹	三個隹 雥 雦
三個雷	三個雷 靐
三個風	三個風 飍
三個飛	三個飛 飝
三個香	三個香 馫
三個马	三個马 骉 𩧢
三個魚	三個魚 鱻
三個鹿	三個鹿 麤
三個龍	三個龍 龘
三個个	三個个 𠁭
三個丶	三個丶 𠁼
三個了	三個了 𠄕
三個介	三個介 𠌕
三個企	三個企 𠐰
三個舍	三個舍 𠑰
三個圥	三個圥 𠒶
三個光	三個光 𠓉
三個兔	三個兔 𠓗
三個全	三個全 𠓾
三個𠙽	三個𠙽 𠚛
三個𠧪	三個𠧪 𠨋
三個㔾	三個㔾 𠨕
三個厡	三個厡 𠫒
三個可	三個可 𠾳
三個因	三個因 𡈲
三個夏	三個夏 𡖃
三個大	三個大 𡘙
三個天	三個天 𡙎
三個太	三個太 𡙒
三個𦉼	三個𦉼 𡚤
三個宝	三個宝 𡬏
三個宜	三個宜 𡬐
三個客	三個客 𡬚
三個寒	三個寒 𡬜
三個少	三個少 𡮏
三個山	三個山 𡷈
三個市	三個市 𢅈
三個文	三個文 𣁕
三個斗	三個斗 𣁾
三個朿	三個朿 𣝯
三個束	三個束 𣠆
三個林	三個林 𣡕
三個果	三個果 𣡗
三個欠	三個欠 𣣓
三個𣥚	三個𣥚 𣦴
三個爪	三個爪 𤔙
三個妥	三個妥 𤕇
三個用	三個用 𤰌
三個甲	三個甲 𤳅
三個百	三個百 𤾩
三個盖	三個盖 𥃣
三個県	三個県 𥍙
三個空	三個空 𥩌
三個亇	三個亇 𥫮 𥫧
三個竹	三個竹 𥴒
三個罒	三個罒 𦋹
三個羗	三個羗 𦏱
三個老	三個老 𦓈
三個月	三個月 𦜳
三個至	三個至 𦥏
三個興	三個興 𦧅
三個足	三個足 𨆬
三個㖖	三個㖖 𨑂
三個門	三個門 𨷮
三個面	三個面 𩉖
三個頁	三個頁 𩖏
三個鳥	三個鳥 𪈼
三個男	三個男 𪟧
三個立	三個立 𫁪
三個九	三個九 𫡤
三個也	三個也 𫡩
三個加	三個加 𫦹
三個動	三個動 𫦿
三個千	三個千 𫧢
三個方	三個方 𬀉
三個朔	三個朔 𬂚
三個玉	三個玉 𬍼
三個申	三個申 𬏍
三個𡿨	三個𡿨 巛
三個去	三個去 𠬑
三個弓	三個弓 𢏝
三個䖝	三個䖝 𧔗
三個丿	三個丿 彡
三個户	三個户 𢩕
三個瓜	三個瓜 𤬑
三個鸟	三個鸟 𪉓
三個米	三個米 𥼬
----------四叠字	----------
四個乂	四個乂 㸚
四個人	四個人 𠈌
四個厶	四個厶 𠫬
四個又	四個又 叕
四個匕	四個匕 𣬅
四個工	四個工 㠭
四個口	四個口 㗊
四個天	四個天 𡚌
四個小	四個小 𡮐
四個屮	四個屮 茻
四個火	四個火 燚
四個牛	四個牛 𤛭
四個魚	四個魚 䲜
四個月	四個月 朤
四個日	四個日 𣊫
四個曰	四個曰 𣊭
四個林	四個林 𣡽
四個水	四個水 㵘
四個石	四個石 𥗉
四個田	四個田 𤳳
四個甲	四個甲 𤳵
四個且	四個且 𠁠
四個囚	四個囚 𡈶
四個困	四個困 𡈹
四個竹	四個竹 𥷹
四個老	四個老 𦓋
四個朿	四個朿 𣡍
四個先	四個先 𠓙
四個金	四個金 𨰻
四個泉	四個泉 𤆁
四個言	四個言 𧮦
四個門	四個門 𨷾
四個果	四個果 𣡾
四個春	四個春 𣌠
四個車	四個車 𨏿
四個風	四個風 𩙡
四個雷	四個雷 䨻
四個雲	四個雲 𩇔
四個興	四個興 𠔻
四個龍	四個龍 𪚥
四個土	四個土 㙓
----------化学式	----------
水	水 💦 H₂O
一氧化二氫	一氧化二氫 H₂O
酒精	酒精 C₂H₆O
乙醇	乙醇 C₂H₆O
錳酸鉀	錳酸鉀 K₂MnO₄
高錳酸鉀	高錳酸鉀 KMnO₄
石灰石	石灰石 CaCO₃
石灰水	石灰水 Ca(OH)₂
膽礬	膽礬 CuSO₄·5H₂O
二氧化氫	二氧化氫 H₂O₂
純鹼	純鹼 Na₂CO₃
熟石灰	熟石灰 Ca(OH)₂
氨水	氨水 NH₃·H₂O
磷酸	磷酸 H₃PO₄
葡萄糖	葡萄糖 C₆H₁₂O₆
硫化鈉	硫化鈉 Na₂S
綠礬	綠礬 FeSO₄·7H₂O
氯酸鉀	氯酸鉀 KClO₃
明礬	明礬 KAl(SO₄)₂·12H₂O
硝酸銨	硝酸銨 NH₄NO₃
食鹽	食鹽 NaCl
氧化鐵	氧化鐵 Fe₂O₃
銅綠	銅綠 Cu₂(OH)₂CO₃
硫酸銅	硫酸銅 CuSO₄
燒鹼	燒鹼 NaOH
蔗糖	蔗糖 C₁₂H₂₂O₁₁
氧化鋁	氧化鋁 Al₂O₃
乾冰	乾冰 CO₂
硫酸鈉	硫酸鈉 Na₂SO₄
亞硝酸鈉	亞硝酸鈉 NaNO₂
纖維素	纖維素 (C₆H₁₀O₅)n
鐵粉	鐵粉 Fe
三聚氰胺	三聚氰胺 C₃H₆N₆
丁烷	丁烷 CH₃CH₂CH₂CH₃
食醋	食醋 CH₃COOH
醋酸	醋酸 CH₃COOH
孔雀石	孔雀石 Cu₂(OH)₂CO₃
草木灰	草木灰 K₂CO₃
丙烷	丙烷 C₃H₈
一氧化碳	一氧化碳 CO
二氧化碳	二氧化碳 CO₂
五氧化二磷	五氧化二磷 P₂O₅
氧化鈉	氧化鈉 Na₂O
二氧化氮	二氧化氮 NO₂
二氧化硅	二氧化硅 SiO₂
二氧化硫	二氧化硫 SO₂
三氧化硫	三氧化硫 SO₃
一氧化氮	一氧化氮 NO
氧化鎂	氧化鎂 MgO
氧化銅	氧化銅 CuO
氧化鋇	氧化鋇 BaO
氧化亞銅	氧化亞銅 Cu₂O
氧化亞鐵	氧化亞鐵 FeO
三氧化二鐵	三氧化二鐵 Fe₂O₃
四氧化三鐵	四氧化三鐵 Fe₃O₄
三氧化二鋁	三氧化二鋁 Al₂O₃
三氧化鎢	三氧化鎢 WO₃
氧化銀	氧化銀 Ag₂O
氧化鉛	氧化鉛 PbO
二氧化錳	二氧化錳 MnO₂
氯化鉀	氯化鉀 KCl
氯化鈉	氯化鈉 NaCl
氯化鎂	氯化鎂 MgCl₂
氯化鈣	氯化鈣 CaCl₂
氯化銅	氯化銅 CuCl₂
氯化鋅	氯化鋅 ZnCl₂
氯化鋇	氯化鋇 BaCl₂
氯化鋁	氯化鋁 AlCl₃
氯化亞鐵	氯化亞鐵 FeCl₂
氯化鐵	氯化鐵 FeCl₃
氯化銀	氯化銀 AgCl
硫酸	硫酸 H₂SO₄
鹽酸	鹽酸 HCl
硝酸	硝酸 HNO₃
碳酸	碳酸 H₂CO₃
亞硫酸	亞硫酸 H₂SO₃
硫化氫	硫化氫 H₂S
溴化氫	溴化氫 HBr
硫酸鋇	硫酸鋇 BaSO₄
硫酸鈣	硫酸鈣 CaSO₄
硫酸鉀	硫酸鉀 K₂SO₄
硫酸鎂	硫酸鎂 MgSO₄
硫酸亞鐵	硫酸亞鐵 FeSO₄
硫酸鐵	硫酸鐵 Fe₂(SO₄)₃
硫酸鋁	硫酸鋁 Al₂(SO₄)₃
硫酸氫鈉	硫酸氫鈉 NaHSO₄
硫酸氫鉀	硫酸氫鉀 KHSO₄
亞硫酸鈉	亞硫酸鈉 NaSO₃
硝酸鈉	硝酸鈉 NaNO₃
硝酸鉀	硝酸鉀 KNO₃
硝酸銀	硝酸銀 AgNO₃
硝酸鎂	硝酸鎂 Mg(NO₃)₂
硝酸銅	硝酸銅 Cu(NO₃)₂
硝酸鈣	硝酸鈣 Ca(NO₃)₂
碳酸鈉	碳酸鈉 Na₂CO₃
碳酸鈣	碳酸鈣 CaCO₃
碳酸鎂	碳酸鎂 MgCO₃
碳酸鉀	碳酸鉀 K₂CO₃
氫氧化鈉	氫氧化鈉 NaOH
氫氧化鈣	氫氧化鈣 Ca(OH)₂
氫氧化鋇	氫氧化鋇 Ba(OH)₂
氫氧化鎂	氫氧化鎂 Mg(OH)₂
氫氧化銅	氫氧化銅 Cu(OH)₂
氫氧化鉀	氫氧化鉀 KOH
氫氧化鋁	氫氧化鋁 Al(OH)₃
氫氧化鐵	氫氧化鐵 Fe(OH)₃
氫氧化亞鐵	氫氧化亞鐵 Fe(OH)₂
甲烷	甲烷 CH₄
乙炔	乙炔 C₂H₂
甲醇	甲醇 CH₃OH
乙酸	乙酸 CH₃COOH
鹼式碳酸銅	鹼式碳酸銅 Cu₂(OH)₂CO₃
石膏	石膏 CaSO₄·2H₂O
熟石膏	熟石膏 2CaSO₄·H₂O
藍礬	藍礬 CuSO₄·₅H₂O
碳酸鈉晶體	碳酸鈉晶體 Na₂CO₃·10H₂O
尿素	尿素 CO(NH₂)₂
硫酸銨	硫酸銨 (NH₄)₂SO₄
碳酸氫銨	碳酸氫銨 NH₄HCO₃
磷酸二氫鉀	磷酸二氫鉀 KH₂PO₄
氯化氫	氯化氫 HCl
氫氧化銨	氫氧化銨 NH₄OH
磷酸二氫鈉	磷酸二氫鈉 NaH₂PO₄
硝酸鋅	硝酸鋅 Zn(NO₃)₂
過氧化氫	過氧化氫 H₂O₂
氧化鉀	氧化鉀 K₂O
氯化銨	氯化銨 NH₄Cl
硝酸鉛	硝酸鉛 Pb(NO₃)₂
硫化銅	硫化銅 CuS
碳酸氫鈉	碳酸氫鈉 NaHCO₃
硝酸鋰	硝酸鋰 LiNO₃
氫氧化鋰	氫氧化鋰 LiOH
磷酸鈣	磷酸鈣 Ca₃(PO₄)₂
苯環	苯環 ⌬ ⏣
----------emoji集合	----------
V動物	V動物 🐶 🐮 🐵 🙈 🙉 🙊 🐒 🐔 🐴 🐷 🐽 🐭 🦐 🦀 🐢 🐱 🐹 🐰 🐻 🐼 🐨 🐧 🐦 🐤 🐣 🐥 🐯 🦁 🐸 🐙 🦆 🦅 🦉 🦇 🐺 🐗 🦄 🐝 🐛 🦋 🐌 🐞 🐜 🕷 🦂 🐍 🦎 🦑 🐠 🐟 🐡 🐬 🐳 🐊 🐆 🐅 🐃 🐂 🐄 🐪 🐫 🐘 🦏 🦍 🐐 🐏 🐑 🐎 🐖 🐀 🐁 🐓 🦃 🕊 🐕 🐩 🐈 🐇 🐿 🦆 🦅 🦉 🦇 🐺 🐗 🦄 🐴 🐝 🐛 🐞 🪲 🦟 🐚 🐌 🦋 🐜 🕷️ 🐢 🐍 🦎 🦂 🦀 🦑 🐙 🦐 🦞 🦪 🐠 🐟 🐡 🪼 🐬 🦈 🐋 🐊 🐆 🐅 🐃 🐂 🐄 🦬 🦌 🐪 🐫 🐘 🦏 🦍 🦧 🦣 🐎 🐖 🐐 🐏 🐑 🐕 🐩 🐈 🐈‍⬛️ 🐇 🐁 🐀 🐿️ 🐉 🐒 🦙 🦛 🫏 🫎 🦖 🦕 🦡 🦝 🦨 🦫 🦦 🦭 🦥 🐓 🦃 🕊️ 🦩 🪿 🦢 🦜 🦤 🦚 🐦‍⬛
V國旗	V國旗 🏳️ 🏴 🏴‍☠️ 🏁 🚩 🏳️‍🌈 🏳️‍⚧️ 🇺🇳 🇦🇺 🇨🇦 🇨🇳 🇩🇪 🇭🇰 🇯🇵 🇳🇿 🇹🇼 🇺🇸
V手勢	V手勢 👌 👍 👎 👊 🤝 ✌️ 💪 🙏 ✊ 👏 👋 🤞 ✋ 🤚 🖖 🤙 🖕 🤟 ☝️ 👆 👇 👈 👉 🤛 🤜 🤲 🤘 🙌 👐 ✍️ 💅
V表情	V表情 😂 ☺️ 😏 😒 🤔 😳 😔 😱 😭 🙈️ 💩 😀 😁 🤣 😄 😅 😆 😇 😉 😊 🙂 🙃 😋 😌 😍 😘 😙 😜 😝 🤑 🤓 😎 🤗 😶 😑 🙄 😞 😟 😠 😡 😕 ☹️ 😣 😖 😫 😤 😮 😨 😰 😯 😦 😢 😥 😪 😓 🤤 😲 🤥 🤢 🤧 🤐 😷 🤒 🤕 😴 😃 😗 😚 😛 🙁 😩 😐 😧 😵 😬 🤪 🤨 🧐 🤩 🤬 🤯 🤭 🤫 🤮 🤡 🤠 😈 👿 👻 💀 👽
V分數	V分數 ½ ⅓ ⅔ ¼ ¾ ⅒ ‰
V按鍵	V按鍵 ⌘ ⌥ ⇧ ⌃ ⎋ ⇪  ⌫ ⌦ ↩︎ ⏎ ␣ ⏏ ⇟ ⇞
V星號	V星號 ＊ × ✱ ★ ☆ ✩ ✧ ❋ ❊ ❉ ❈ ❅ ✿ ✲
V特殊	V特殊 © ® ℗ ⓘ ℠ ™ ℡ ␡ ♂ ♀ ☉ ☊ ☋ ☌ ☍ ☐ ☑︎ ☒ ☜ ☝ ☞ ☟ ✎ ✄ ♻ ⚐ ⚑ ⚠
V常用	V常用 👌 👍 😂 😅 😡 😮 😱 😭 😘 😰 💩
V中華	V中華 🧧 🥮 🧨 🧮
V中餐	V中餐 🍜 🍚 🍲 🥘 🥟 🥠 🥡 🥢
V串串	V串串 🍢 🍡
V亞裔	V亞裔 🧓🏻 🧑🏻 🧒🏻 👶🏻
V亞裔女	V亞裔女 👵🏻 👩🏻 👧🏻
V亞裔男	V亞裔男 👴🏻 👨🏻 👦🏻
V運動	V運動 🏒 🏸 🏓 🏑 🏏 ⛳️ 🏹 ⚽️ 🏀 🏈 ⚾️ 🥎️ 🎾 🏐 🏉 🎱 ⛸️ 🛼 🎿 🎳 🥏 🥍 🛹 🤿 🪂 🛷 🥌 🪃 🪁
V運動員	V運動員 ⛷️ 🏂🏻 🏋🏻 🤺 🤼🏻 🤸🏻 ⛹🏻 🤾🏻 🏌🏻 🏄🏻 🏊🏻 🤽🏻 🚣🏻 🏇🏻 🚴🏻 🚵🏻 🧗🏻 🤹🏻
V元素	V元素 💧 🔥 🌪️ 🪨 🪵 ⚡️ 🧊
V公交	V公交 🚌 🚎 🚍 🚈 🚇 🚊
V動物臉	V動物臉 🐶 🐱 🐭 🐹 🐰 🦊 🐻 🐻‍❄️ 🐼 🐨 🐯 🦁 🐮 🐷 🐽 🐸 🐵
V包	V包 👝 👛 👜 💼 🧳 🎒
V午餐	V午餐 🍛 🍲 🍝 🍜 🥘 🍣 🍱 🍘 🍙 🍚 🥡
V飯	V飯 🍛 🍲 🍝 🍜 🥘 🍣 🍱 🍘 🍙 🍚 🥡
V景點	V景點 🗽 🏰 🗼 🗻 🏯 🏝️ 🏖️ 🌁 🌉 🏞️
V器官	V器官 👁️ 👂🏻 👃🏻 👄 🦷 🧠 🫁 🫀 🦵🏻 🦶🏻 🖐🏻 👅
V圓形	V圓形 🔴 🟠 🟡 🟢 🔵 🟣 🟤 ⚫️ ⚪️
V地鐵	V地鐵 🚈 🚇 🚊 🚞 🚋 🚃 🚟
V交通	V交通 🚈 🚇 🚊 🚞 🚋 🚃 🚟
V堅果	V堅果 🥜 🌰️
V外匯	V外匯 💵 💶 💷 💴
V鈔票	V鈔票 💵 💶 💷 💴
V紙幣	V紙幣 💵 💶 💷 💴
V貨幣	V貨幣 💵 💶 💷 💴
V多媒體	V多媒體 📽️ 🎥 📹 📷 🎙️ 📡
V夜晚	V夜晚 🌙 💫 ⭐️ 🌟 ✨ 🌛 🌜
V夜空	V夜空 🌙 💫 ⭐️ 🌟 ✨ 🌛 🌜
V大自然	V大自然 🔥 💧 🌬️ 🫧 ☀️ 🌤️ ⛅️ 🌦️ 🌥️ ☁️ 🌨️ 🌧️ 🌩️ ⛈️ ❄️ 💨 🌪️ 🌫️ 🌊 🧊 🪨
V自然	V自然 🔥 💧 🌬️ 🫧 ☀️ 🌤️ ⛅️ 🌦️ 🌥️ ☁️ 🌨️ 🌧️ 🌩️ ⛈️ ❄️ 💨 🌪️ 🌫️ 🌊 🧊 🪨
V氣象	V氣象 ☀️ 🌤️ ⛅️ 🌦️ 🌥️ ☁️ 🌨️ 🌧️ 🌩️ ⛈️ ❄️ 💨 🌪️ 🌫️ 🌊
V天氣	V天氣 ☀️ 🌤️ ⛅️ 🌦️ 🌥️ ☁️ 🌨️ 🌧️ 🌩️ ⛈️ ❄️ 💨 🌪️ 🌫️ 🌊
V娛樂	V娛樂 🎮 🎰 🎲 🎯 🎳 🎧 🎤️ 🎪 🎫 🎟️ ♟️ 🕹️ 🖲️ 🪀 🪩
V宗教	V宗教 ✝️ ☪️ 🕉️ ☸️ 🔯 🕎 ☯️ ☦️ 🪯 🛐 ⛪️ 🕌 🕍 🕋 ⛩️ 🛕
V家禽	V家禽 🦆 🐓 🦃 🐔 🐤 🐣 🐥 🦚 🪿
V冷	V冷 ❄️ 🌨️ ☃️ ⛄️ 🧊
V寒冷	V寒冷 ❄️ 🌨️ ☃️ ⛄️ 🧊
V工具	V工具 ⚙️ 🔩 ⛏️ 🛠️ ⚒️ 🔨 🔧 ⛓️ 🧰 🪒 🪚 🪛 🪜 🪡
V帽	V帽 👒 🧢 🎩 🎓 ⛑️ 🪖
V帽子	V帽子 👒 🧢 🎩 🎓 ⛑️ 🪖
V心心	V心心 ❤️ 🧡 💛 💚 💙 🩵 🩷 💜 🤎 🖤 🩶 🤍
V快餐	V快餐 🍔 🌭 🍟 🥞 🥡 🥫
V怪物	V怪物 🦄 🤖 👾 👹 👺
V拉丁	V拉丁 🧓🏽 🧑🏽 🧒🏽 👶🏽
V拉丁裔	V拉丁裔 🧓🏽 🧑🏽 🧒🏽 👶🏽
V拉美	V拉美 🧓🏽 🧑🏽 🧒🏽 👶🏽
V拉美人	V拉美人 🧓🏽 🧑🏽 🧒🏽 👶🏽
V拉美裔	V拉美裔 🧓🏽 🧑🏽 🧒🏽 👶🏽
V卷	V卷 🥙 🌮 🌯 🫔
V數碼	V數碼 ⌚️ 📱 💻 ⌨️ 🖥️ 🖨️ 🖱️ 📷 📹 💾 💽 💿 📀
V方形	V方形 🟥 🟧 🟨 🟩 🟦 🟪 🟫 ⬛️ ⬜️
V正方形	V正方形 🟥 🟧 🟨 🟩 🟦 🟪 🟫 ⬛️ ⬜️
V日料	V日料 🍥 🍣 🍱 🍙 🍘
V日式料理	V日式料理 🍥 🍣 🍱 🍙 🍘
V日本菜	V日本菜 🍥 🍣 🍱 🍙 🍘
V日用	V日用 🧴 🧼 🧻 🧽 🪥 🪒 💄 🪣
V早餐	V早餐 🍳 🥚 🧀 🥖 🥛 🍯 🥪 🥫 🥯 🧇 🫓
V早點	V早點 🍳 🥚 🧀 🥖 🥛 🍯 🥪 🥫 🥯 🧇 🫓
V星座	V星座 ♒️ ♓️ ♈️ ♉️ ♊️ ♋️ ♌️ ♍️ ♎️ ♏️ ♐️ ♑️
V時鐘	V時鐘 🕛 🕧 🕐 🕜 🕑 🕝 🕒 🕞 🕓 🕟 🕔 🕠 🕕 🕡 🕖 🕢 🕗 🕣 🕘 🕤 🕙 🕥 🕚 🕦
V月亮	V月亮 🌕 🌖 🌗 🌘 🌑 🌒 🌓 🌔
V有毒	V有毒 ☢️ ☣️ 🦠
V服裝	V服裝 🧥 👚 👕 👖 🩳 👔 👗 👘 🥻 🩲 👙 🩱 🥼
V服飾	V服飾 🧥 👚 👕 👖 🩳 👔 👗 👘 🥻 🩲 👙 🩱 🥼
V東亞人	V東亞人 🧓🏻 🧑🏻 🧒🏻 👶🏻
V東亞裔	V東亞裔 🧓🏻 🧑🏻 🧒🏻 👶🏻
V果	V果 🍏 🍎 🍐 🍊 🍋 🍌 🍉 🍇 🍓 🫐 🍈 🍒 🍑 🍍 🥝 🥑 🥥 🥭
V水果	V水果 🍏 🍎 🍐 🍊 🍋 🍌 🍉 🍇 🍓 🫐 🍈 🍒 🍑 🍍 🥝 🥑 🥥 🥭
V棕色人	V棕色人 🧓🏽 🧑🏽 🧒🏽 👶🏽
V棕色人種	V棕色人種 🧓🏽 🧑🏽 🧒🏽 👶🏽
V植物	V植物 🌲 🌳 🎄 🌵 🌴 🌱 🌿 ☘️ 🍀 🎍 🪴 🌾 🥬 🪻
V樂器	V樂器 🎻 🎸 🎹 🎷 🎺 🥁 🪕 🪘 🪗 🪈 🪇
V機械	V機械 ⚙️ 🔩 ⛏️ 🛠️ ⚒️ 🔨 🔧 ⛓️ 🧰 🪒 🪚 🪛 🪜 🪡
V正餐	V正餐 🥘 🍜 🍲 🍛 🍝 🍱 🍚 🥗
V武器	V武器 🔫 🗡️ ⚔️ 🔪 🛡️ 🪓 🚀
V車	V車 🚗 🚕 🚙 🚌 🚎 🏎️ 🚓 🚑 🚒 🚐 🚚 🚛 🎢 🛻 🚔 🚍 🚘 🚖 🛺
V汽車	V汽車 🚗 🚕 🚙 🚌 🚎 🏎️ 🚓 🚑 🚒 🚐 🚚 🚛 🎢 🛻 🚔 🚍 🚘 🚖 🛺
V火車	V火車 🚄 🚅 🚝 🚆 🚂 🚉
V熱飲	V熱飲 ☕️ 🍵
V牲畜	V牲畜 🐄 🐃 🐂 🦬 🐐 🐏 🐖 🐑 🐕 🦮 🐕‍🦺 🐩 🐈 🐈‍⬛️ 🫏 🫎
V獎	V獎 🏅 🎖️ 🥇 🥈 🥉 🏆
V獎項	V獎項 🏅 🎖️ 🥇 🥈 🥉 🏆
V獎牌	V獎牌 🏅 🎖️ 🥇 🥈 🥉 🏆
V球	V球 ⚽️ 🏀 🏈 🏐 🏉 ⚾️ 🥎️ 🎾 🎱 🪀 🏓 🏸 🏒 🏑 🏏 🛹 🥍
V甜食	V甜食 🍯 🍰 🍮 🎂 🍭 🍬 🍫 🍩 🍪 🍦 🧁
V甜點	V甜點 🍮 🍩 🍪 🍧 🍨 🍦 🍰 🧁 🧇 🧆
V生肖	V生肖 🐁 🐀 🐂 🐃 🐄 🦬 🐅 🐆 🐇 🐉 🐍 🐎 🐏 🐐 🐑 🐒 🦧 🦍 🦃 🐓 🐕 🦮 🐕‍🦺 🐖 🐗
V畜生	V畜生 🐄 🐃 🐂 🦬 🐐 🐏 🐖 🐑 🐕 🦮 🐕‍🦺 🐩 🐈 🐈‍⬛️ 🫏 🫎
V白人	V白人 🧓🏼 🧑🏼 👱🏼 🧒🏼 👶🏼
V白種人	V白種人 🧓🏼 🧑🏼 👱🏼 🧒🏼 👶🏼
V眼鏡	V眼鏡 👓 🕶️ 🥽
V科學	V科學 🔬 🔭 ⚗️ ⚛️ 🧑🏻‍🔬 🧬 🧪 🧫 🩺 🩻
V穆斯林	V穆斯林 👳🏽
V節日	V節日 🎊 🎉 🪅 🎏 🎎 🏮 🎐 🧧 🎁 🧨 🎇 🎆 🎑 🎄 🧑🏻‍🎄
V粗糧	V粗糧 🌽 🥔 🍠 🥜 🌰
V精靈	V精靈 🧙🏻 🧝🏻 🧛🏻 🧟 🧞 🧜🏻 🧚🏻 🦹🏻
V肉	V肉 🥩 🥓 🍗 🍖 🍤
V膚色	V膚色  🏼 🏽 🏾 🏿
V船	V船 🚢 ⛴️ 🛳️ 🛥️ 🚤 ⛵️ 🛶 ⚓️
V花	V花 🌸 🌺 🌼 🌻 🌷 🌹 💐 🥀 🪷 🪻
V花朵	V花朵 🌸 🌺 🌼 🌻 🌷 🌹 💐 🥀 🪷 🪻
V菜	V菜 🍅 🍆 🥒 🥕 🌶️ 🥦 🥗 🥬 🫒 🫑 🫘 🫛
V蔬菜	V蔬菜 🍅 🍆 🥒 🥕 🌶️ 🥦 🥗 🥬 🫒 🫑 🫘 🫛
V葉子	V葉子 🍃 🍂 🍁 🌱 🌿 🥬
V蟲	V蟲 🐛 🪱 🐞 🪲 🪳 🦗 🦟 🐜 🪰 🐌 🐝
V血型	V血型 🅰️ 🅱️ 🅾️ 🆎️
V衣服	V衣服 🧥 👚 👕 👖 🩳 👔 👗 👘 🥻 🩲 👙 🩱 🥼
V西餐	V西餐 🍕 🥓 🧀 🥖 🥐 🍝 🌯 🌮 🥙 🍟 🍔 🌭 🥞 🥪 🥯 🧇 🫕
V調料	V調料 🧄 🫚 🧅 🧂 🧀
V遊樂園	V遊樂園 🏟️ 🎡 🎢 🎠 🛝
V酒	V酒 🍷 🥃 🍺 🍶 🍾 🍸
V野味	V野味 🦉 🦇 🐍 🐢 🦝 🦨 🦡 🦫 🐿️ 🦦 🦥 🦔 🐺 🐗 🐡 🐬 🐳 🐋 🦈 🦭 🐊 🐅 🐆 🦓 🦍 🦧 🐘 🦛 🦏 🦒 🦘 🦩 🫏 🫎
V野生動物	V野生動物 🦉 🦇 🐍 🐢 🦝 🦨 🦡 🦫 🐿️ 🦦 🦥 🦔 🐺 🐗 🐡 🐬 🐳 🐋 🦈 🦭 🐊 🐅 🐆 🦓 🦍 🦧 🐘 🦛 🦏 🦒 🦘 🦩 🫏 🫎
V阿拉伯	V阿拉伯 👳🏽 🧔🏽 🧕🏽
V阿拉伯人	V阿拉伯人 👳🏽 🧔🏽 🧕🏽
V雪	V雪 ❄️ 🌨️ ☃️ ⛄️ 🧊
V零食	V零食 🍭 🍬 🍫 🍿 🍩 🍪
V電器	V電器 💡 📺 ☎️ 📟 📞 📠 📻 🕰️ 📡 🔦
V電子	V電子 ⌚️ 📱 💻 ⌨️ 🖥️ 🖨️ 🖱️ 📷 📹 💾 💽 💿 📀
V鞋	V鞋 👡 👢 👞 👟 🥾 🥿 👠 🛼 ⛸️
V鞋子	V鞋子 👡 👢 👞 👟 🥾 🥿 👠 🛼 ⛸️
V顏色	V顏色 🟥 🟧 🟨 🟩 🟦 🟪 🟫 ⬛️ ⬜️ 🔴 🟠 🟡 🟢 🔵 🟣 🟤 ⚫️ ⚪️ ❤️ 🧡 💛 💚 💙 🩵 🩷 💜 🤎 🖤 🩶 🤍
V飛行器	V飛行器 🛩️ ✈️ 🚁 🚀 🛸
V飲料	V飲料 🧋 🍹 🧃 🍸 🍵 ☕️ 🥛 🍷 🥃 🍶 🥂 🍾 🍻 🍺 🧉
V餐具	V餐具 🥄 🍴 🍽️ 🥣 🥢 🫖
V髮型	V髮型 🦲 🦰 🦱 🦳
V髮色	V髮色 🦲 🦰 🦱 🦳
V魚	V魚 🐠 🐟 🐡 🪼 🐬 🐳 🐋 🦈 🦭 🦦
V鳥	V鳥 🦆 🦅 🦉 🦇 🐓 🦃 🕊️ 🐧 🐦 🦚 🦜 🦩 🦤 🦢 🪿 🐦‍⬛
V麵包	V麵包 🍞 🥐 🥖 🥨 🥯 🍩 🥮
V黃種人	V黃種人 🧓🏻 🧑🏻 🧒🏻 👶🏻
V黑人	V黑人 🧓🏿 🧑🏿 🧒🏿 👶🏿
V點心	V點心 🍮 🍩 🍪 🍧 🍨 🍦 🍰 🧁 🧇 🧆
----------希腊字母	----------
阿爾法	阿爾法 alpha α Α
貝塔	貝塔 beta β Β
伽馬	伽馬 gamma γ Γ
德爾塔	德爾塔 delta δ Δ
艾普西隆	艾普西隆 epsilon ε Ε
澤塔	澤塔 zeta ζ Ζ
伊塔	伊塔 eta η Η
西塔	西塔 theta θ Θ
約塔	約塔 iota ι Ι
卡帕	卡帕 kappa κ Κ
拉姆達	拉姆達 lambda λ Λ
----------（太短了不启用了）谬	谬 mu μ Μ
----------（太短了不启用了）纽	纽 nu ν Ν
克西	克西 ξ Ξ
奧密克戎	奧密克戎 omicron ο Ο
----------（太短了不启用了）派	派 pi π Π
----------（太短了不启用了）柔	柔 rho ρ Ρ
西格馬	西格馬 sigma σ/ς Σ
----------（太短了不启用了）陶	陶 tau τ Τ
宇普西隆	宇普西隆 upsilon υ Υ
----------（太短了不启用了）斐	斐 phi φ Φ
----------（太短了不启用了）希	希 chi χ Χ
普西	普西 psi ψ Ψ
奧米伽	奧米伽 omega ω Ω
希臘字母	希臘字母 αΑ βΒ γΓ δΔ εΕ ζΖ ηΗ θΘ ιΙ κΚ λΛ μΜ νΝ ξΞ οΟ πΠ ρΡ σςΣ τΤ υΥ φΦ χΧ ψΨ ωΩ
希臘字母小寫	希臘字母小寫 α β γ δ ε ζ η θ ι κ λ μ ν ξ ο π ρ σς τ υ φ χ ψ ω
希臘字母大寫	希臘字母大寫 Α Β Γ Δ Ε Ζ Η Θ Ι Κ Λ Μ Ν Ξ Ο Π Ρ Σ Τ Υ Φ Χ Ψ Ω
小寫希臘字母	小寫希臘字母 α β γ δ ε ζ η θ ι κ λ μ ν ξ ο π ρ σς τ υ φ χ ψ ω
大寫希臘字母	大寫希臘字母 Α Β Γ Δ Ε Ζ Η Θ Ι Κ Λ Μ Ν Ξ Ο Π Ρ Σ Τ Υ Φ Χ Ψ Ω
alpha	alpha α Α
beta	beta β Β
gamma	gamma γ Γ
delta	delta δ Δ
epsilon	epsilon ε Ε
zeta	zeta ζ Ζ
eta	eta η Η
theta	theta θ Θ
iota	iota ι Ι
kappa	kappa κ Κ
lambda	lambda λ Λ
mu	mu μ Μ
nu	nu ν Ν
xi	xi ξ Ξ
omicron	omicron ο Ο
pi	pi π Π
rho	rho ρ Ρ
sigma	sigma σ ς Σ
tau	tau τ Τ
upsilon	upsilon υ Υ
phi	phi φ Φ
chi	chi χ Χ
psi	psi ψ Ψ
omega	omega ω Ω
----------数学	----------
乘號	乘號 ×
叉乘	叉乘 ⨯
點乘	點乘 ⋅
除號	除號 ÷
正負	正負 ±
正負號	正負號 ±
負正	負正 ∓
負正號	負正號 ∓
等於	等於 =
等於號	等於號 =
約等	約等 ≈
約等於	約等於 ≈
約等號	約等號 ≈
不等	不等 ≠
不等於	不等於 ≠
不等號	不等號 ≠
大於	大於 > ≥
大於號	大於號 > ≥
小於	小於 < ≤
小於號	小於號 < ≤
小於等於	小於等於 ≤
小於等於號	小於等於號 ≤
大於等於	大於等於 ≥
大於等於號	大於等於號 ≥
正比於	正比於 ∝
成比例	成比例 ∝
求和	求和 ∑
累加	累加 ∑
連加	連加 ∑
求積	求積 ∏
累乘	累乘 ∏
連乘	連乘 ∏
增量	增量 ∆
變化量	變化量 ∆
積分	積分 ∫
二重積分	二重積分 ∬
三重積分	三重積分 ∭
偏微分	偏微分 ∂
空集	空集 ∅
交集	交集 ∩
並集	並集 ∪
補集	補集 ∁
差集	差集 ∖
屬於	屬於 ∈
不屬於	不屬於 ∉
包含	包含 ⊃ ⊇
不包含	不包含 ⊅ ⊉
包含於	包含於 ⊂ ⊆
不包含於	不包含於 ⊄ ⊈
合取	合取 ∧
邏輯與	邏輯與 ∧
析取	析取 ∨
邏輯或	邏輯或 ∨
否定	否定 ¬
邏輯非	邏輯非 ¬
蘊涵	蘊涵 → ⇒
等價	等價 ↔ ⇔
異或	異或 ⊻
與非	與非 ⊼
或非	或非 ⊽
任意	任意 ∀
全稱量詞	全稱量詞 ∀
存在	存在 ∃
存在量詞	存在量詞 ∃
不存在	不存在 ∄
無限	無限 ∞
無限大	無限大 ∞
無窮大	無窮大 ∞
無窮大符號	無窮大符號 ∞
正無窮	正無窮 +∞
負無窮	負無窮 -∞
aleph	aleph ℵ
阿列夫	阿列夫 ℵ
圓周率	圓周率 π
Nabla算子	Nabla算子 ∇
劈形算子	劈形算子 ∇
劈形算符	劈形算符 ∇
倒三角算符	倒三角算符 ∇
二分之一	二分之一 ½
三分之一	三分之一 ⅓
三分之二	三分之二 ⅔
四分之一	四分之一 ¼
四分之三	四分之三 ¾
五分之一	五分之一 ⅕
五分之二	五分之二 ⅖
五分之三	五分之三 ⅗
五分之四	五分之四 ⅘
六分之一	六分之一 ⅙
六分之五	六分之五 ⅚
七分之一	七分之一 ⅐
八分之一	八分之一 ⅛
八分之三	八分之三 ⅜
八分之五	八分之五 ⅝
八分之七	八分之七 ⅞
九分之一	九分之一 ⅑
十分之一	十分之一 ⅒
百分百	百分百 100%
百分號	百分號 %
百分之	百分之 %
千分號	千分號 ‰
千分之	千分之 ‰
萬分號	萬分號 ‱
萬分之	萬分之 ‱
i次方	i次方 ⁱ
i次冪	i次冪 ⁱ
n次方	n次方 ⁿ
n次冪	n次冪 ⁿ
零次方	零次方 ⁰
零次冪	零次冪 ⁰
一次方	一次方 ¹
一次冪	一次冪 ¹
二次方	二次方 ²
兩次方	兩次方 ²
二次冪	二次冪 ²
平方	平方 ²
平方根	平方根 √
根號	根號 √
開根	開根 √
開根號	開根號 √
三次方	三次方 ³
三次冪	三次冪 ³
立方	立方 ³
立方根	立方根 ∛
四次方	四次方 ⁴
四次冪	四次冪 ⁴
四次方根	四次方根 ∜
五次方	五次方 ⁵
五次冪	五次冪 ⁵
六次方	六次方 ⁶
六次冪	六次冪 ⁶
七次方	七次方 ⁷
七次冪	七次冪 ⁷
八次方	八次方 ⁸
八次冪	八次冪 ⁸
九次方	九次方 ⁹
九次冪	九次冪 ⁹
十次方	十次方 ¹⁰
十次冪	十次冪 ¹⁰
向下取整	向下取整 ⌊⌋
向上取整	向上取整 ⌈⌉
角	角 ∠
平行	平行 ∥
垂直	垂直 ⟂
----------单位	----------
平方釐米	平方釐米 cm²
平方分米	平方分米 dm²
平方米	平方米 m²
立方厘米	立方厘米 cm³
立方分米	立方分米 dm³
立方米	立方米 m³
度	度 °
攝氏度	攝氏度 °C
華氏度	華氏度 °F
毫秒	毫秒 ms millisecond
微秒	微秒 μs microsecond
納秒	納秒 ns nanosecond
皮秒	皮秒 ps picosecond
飛秒	飛秒 fs femtosecond
阿秒	阿秒 as attosecond
毫米	毫米 mm millimeter
微米	微米 μm micrometer
納米	納米 nm nanometer
英寸	英寸 吋
千瓦	千瓦 瓩
----------笔画标点	----------
點	點 · 丶
橫	橫 一
豎	豎 丨
撇	撇 丿
捺	捺 ㇏
豎彎鉤	豎彎鉤 乚
橫折	橫折 𠃍
橫折鉤	橫折鉤 𠃌
頓號	頓號 、
間隔號	間隔號 ·
連接號	連接號 —
連接符	連接符 —
連字符	連字符 －
破折號	破折號 ——
反引號	反引號 `
反問號	反問號 ¿
書名號	書名號 《》 〈〉
直角引號	直角引號 「」 『』
六角括號	六角括號 〔〕
方頭括號	方頭括號 【】 〖〗
疊字符號	疊字符號 々 〻
重文符號	重文符號 々 〻
分節符	分節符 §
分段符	分段符 ¶
段落符號	段落符號 ¶
劍號	劍號 †
雙劍號	雙劍號 ‡
----------其他	----------
牛皮	牛皮 🐮🍺
魯迅	魯迅 👨🏻
周樹人	周樹人 👨🏻
魯迅餵奶	魯迅餵奶 👨🏻‍🍼
rime	rime 㞢
中州韻	中州韻 Rime
鼠須管	鼠須管 Squirrel
小狼毫	小狼毫 Weasel
倉輸入法	倉輸入法 Hamster
納粹	納粹 卐
進擊的巨人	進擊的巨人 進撃の巨人
中央電視台	中央電視台 裝墊兒台
裝墊兒台	裝墊兒台 中央電視台
Geralt	Geralt 傑洛特
傑洛特	傑洛特 Geralt
滅霸	滅霸 Thanos
Thanos	Thanos 滅霸
皮卡丘	皮卡丘 Pikachu
Pikachu	Pikachu 皮卡丘
Pokemon	Pokemon Pokémon
恭喜發財	恭喜發財
人上人	人上人 仌
二百	二百 皕
兩百	兩百 皕
雙喜	雙喜 囍
雙喜臨門	雙喜臨門 囍
喜上加喜	喜上加喜 囍
又又又又	又又又又 又雙叒叕
掀桌子	掀桌子 (╯'-')╯︵┻━┻ (╯°Д°)╯︵┻━┻
擺桌子	擺桌子 ┬─┬ノ('-'ノ)
車馬炮	車馬炮
出車	出車
阿爾法粒子	阿爾法粒子 α粒子
阿爾法射線	阿爾法射線 α射線
貝塔粒子	貝塔粒子 β粒子
貝塔射線	貝塔射線 β射線
伽馬刀	伽馬刀 γ刀
伽馬射線	伽馬射線 γ射線
六字真言	六字真言 唵嘛呢叭咪吽 愛玩玩不玩滾
六字大明咒	六字大明咒 唵嘛呢叭咪吽
星巴克	星巴克 Starbucks
安卓	安卓 Android
推特	推特 𝕏
Twitter	Twitter 𝕏
橡膠果實	橡膠果實 幻獸種·人人果實·尼卡（太陽神）形態
奔馳	奔馳 Benz Mercedes-Benz
梅賽德斯	梅賽德斯 Mercedes
梅賽德斯-奔馳	梅賽德斯-奔馳 Mercedes-Benz
ankh	ankh ☥
生命之符	生命之符 ☥
雙蛇杖	雙蛇杖 ☤
雙蛇之杖	雙蛇之杖 ☤
商神杖	商神杖 ☤
商神之杖	商神之杖 ☤
商神權杖	商神權杖 ☤
